52 52 52 46 46 52 52 52 52 52 52 52 52 52 52 52 52 52 52 52 52 52 52 52 52 52 52 52 52 52 52 52 52 52 52 52 52 52 52 52 
52 52 46 46 46 46 46 52 52 52 52 52 52 52 52 52 52 52 52 52 52 52 52 52 46 52 52 52 52 52 52 52 52 52 52 52 52 52 52 52 
52 46 43 43 43 43 43 46 52 52 52 52 52 52 52 52 52 52 52 52 46 46 46 46 43 46 52 52 52 52 52 52 52 52 52 52 52 52 52 52 
52 46 43 43 43 43 43 46 52 52 52 52 52 52 52 52 52 52 52 52 52 46 43 43 43 43 46 52 52 52 52 52 52 52 52 52 52 52 52 52 
52 46 46 43 43 43 43 46 52 52 52 52 52 52 52 52 52 52 52 52 52 52 46 43 43 46 46 52 52 52 52 52 52 52 52 52 52 52 52 52 
52 52 52 46 46 46 46 52 52 52 52 52 52 52 52 52 52 52 52 52 52 52 52 46 46 52 52 52 52 52 52 52 52 52 52 52 52 52 52 52 
52 52 52 52 52 52 52 52 52 52 52 52 52 52 52 52 52 52 52 52 52 52 52 52 52 52 52 52 52 52 52 52 52 52 52 52 52 52 52 52 
52 52 52 52 52 52 52 52 52 52 52 52 52 52 52 52 52 52 52 52 52 52 52 52 52 52 52 52 52 52 52 52 52 52 52 52 52 52 52 52 
52 52 52 52 52 52 52 52 52 52 52 52 52 52 52 52 52 52 52 52 52 52 52 52 52 52 52 52 52 52 52 52 52 52 52 52 52 52 52 52 
52 52 52 52 52 52 52 52 52 52 52 52 52 52 52 52 52 52 52 52 52 52 52 52 52 52 52 52 52 52 52 52 52 46 52 52 52 52 52 52 
52 52 52 52 52 52 52 52 52 52 52 52 52 52 52 52 52 52 52 52 52 52 52 52 52 52 52 52 52 52 52 52 46 43 46 52 52 52 52 52 
52 52 52 52 52 52 52 52 52 52 52 52 52 52 52 52 52 52 52 52 52 52 52 52 52 52 52 52 52 52 52 52 46 43 43 46 52 52 52 52 
52 52 52 52 52 52 52 52 52 52 52 52 52 52 52 52 52 52 52 52 52 52 52 52 52 52 52 52 52 52 52 46 43 43 43 43 46 52 52 52 
52 52 52 52 52 52 52 52 52 52 52 52 52 52 52 52 52 52 52 52 52 52 52 52 52 52 52 52 52 52 52 46 43 43 43 46 52 52 52 52 
52 52 52 52 52 52 52 52 52 52 52 52 52 52 52 52 52 52 52 52 52 52 52 52 52 52 52 52 52 52 52 52 46 43 43 46 52 52 52 52 
52 52 52 52 52 52 52 52 52 52 52 52 52 52 52 52 52 52 52 52 52 52 52 52 52 52 52 52 52 52 52 52 46 46 43 46 52 52 52 52 
52 52 52 52 52 52 52 52 52 52 52 46 46 46 46 52 52 52 52 52 52 52 52 52 52 52 52 52 52 52 52 52 52 46 46 52 52 52 52 52 
52 52 52 52 52 52 52 52 52 52 52 46 43 43 43 46 52 52 52 52 52 52 52 52 52 52 52 46 52 52 52 52 52 52 52 52 52 52 52 52 
52 52 52 52 52 52 52 52 52 52 52 46 43 43 43 43 46 52 52 52 52 52 52 52 52 52 46 43 46 52 52 52 52 52 52 52 52 52 52 52 
52 52 52 52 52 52 52 52 52 52 52 52 46 43 43 43 46 52 52 52 52 52 52 52 52 52 46 43 43 46 52 52 52 52 52 52 52 52 52 52 
52 52 52 52 52 52 52 52 52 52 52 52 46 43 43 46 52 52 52 52 52 52 52 52 52 52 46 43 43 46 52 52 52 52 52 52 52 52 52 52 
52 52 52 52 52 52 52 52 52 52 52 52 46 43 46 46 52 52 52 52 52 52 52 52 52 52 52 46 46 52 52 52 52 52 52 52 52 52 52 52 
52 52 52 52 52 52 52 52 52 52 52 52 52 46 52 52 52 52 52 52 52 52 52 52 52 52 52 52 52 52 52 52 52 52 52 52 52 52 52 52 